##########
#.......F#
####.#.##
#...#A..#
#.#.#.##
#.#.#...#
#.#.####
#.#.....#
#...#.##
##########
