####################
#....#........#.....#
#.##.#.####.#.####.#
#.#D#.#A..#.#B..#.#
#.##.#.##.#.##..#.#
#.........#......#.#
########.#.####.#.#
#........#......#.#
#.#######.####.#.#
#.#...#...#...#.#
#.#.#.####.#.#.#
#...#...#...#.#
####.#.####.#.#
#...........#.#
#.#########.#.#
#.#...#...#.#.#
#.#.#.####.#.#
#...#...#...#.#
################F#
#################### 