####################
#....#........#....F#
#.##.#.####.#.####.#
#.#D#.#A..#.#B..#.#
#.##.#.##.#.##..#.#
#.........#......#.#
########.#.####.#.#
#........#......#.#
#.#######.####.#.#
#################### 